41,59,59,59,59,59,41,59,59,59,59,59,59,59,59,59,59,59,59,59,59,59,59,59,59,59,59,59,59,59,59,59,33,35,41
57,0,0,0,0,0,57,38,39,40,48,48,38,39,40,48,41,23,23,23,23,23,41,48,48,48,48,57,48,48,48,48,48,48,57
57,0,0,0,0,0,57,48,48,48,48,48,48,48,48,48,57,23,23,23,23,23,3,48,48,48,48,3,48,48,48,48,48,6,57
57,0,0,0,0,0,57,48,48,48,48,48,48,48,48,48,57,23,23,23,23,23,19,48,48,48,48,19,48,48,48,48,48,22,57
57,0,0,0,0,0,57,48,48,48,48,48,48,48,48,48,57,23,23,23,23,23,57,48,48,48,48,57,48,48,48,48,48,38,57
57,0,0,0,0,0,57,48,48,48,48,48,48,48,48,48,57,59,59,59,59,59,59,59,59,59,59,57,48,48,48,48,48,6,57
57,0,0,0,0,0,57,48,48,48,48,48,48,48,48,48,38,39,40,48,38,39,40,48,38,39,40,48,48,48,48,48,48,22,57
57,0,0,0,0,0,3,48,48,48,48,48,48,48,48,48,48,48,48,48,48,48,48,48,48,48,48,48,48,48,48,48,48,38,57
57,0,0,0,0,0,19,48,48,48,48,48,48,48,48,48,48,48,48,48,48,48,48,48,48,48,48,48,48,48,48,48,48,48,57
57,0,0,0,0,0,57,48,48,48,48,48,48,48,48,48,6,7,8,48,6,7,8,48,6,7,8,48,48,48,48,48,48,48,57
57,0,0,0,0,0,57,48,48,48,48,48,41,59,59,59,59,59,59,59,59,59,59,59,59,59,59,59,59,59,59,59,49,50,57
57,0,0,0,0,0,57,6,7,7,7,8,57,32,32,32,32,32,32,32,32,32,32,32,32,32,32,32,32,32,32,32,32,32,57
57,0,0,0,0,0,57,38,39,39,39,40,57,32,32,32,32,32,32,32,32,32,32,32,32,32,32,32,32,32,32,32,32,32,57
57,0,0,0,0,0,41,73,73,73,73,74,58,59,59,59,59,59,59,59,59,59,59,59,59,59,59,59,59,59,59,32,32,32,57
57,0,0,0,0,0,57,64,64,64,64,64,64,64,64,64,64,64,64,64,64,64,64,64,64,64,64,64,64,64,64,64,64,64,57
-70,-127,-127,-127,-127,-127,-70,-63,-63,-63,-63,-63,-63,-63,-63,-63,-63,-63,-63,-63,-63,-63,-63,-63,-63,-63,-63,-63,-63,-63,-63,-63,-63,-63,-70
-70,-127,-127,-127,-127,-127,-63,-63,-63,-63,-63,-63,-63,-63,-63,-63,-63,-63,-63,-63,-63,-63,-63,-63,-63,-63,-63,-63,-63,-63,-69,-68,-68,-68,-70
-70,-127,-127,-127,-127,-127,-63,-59,-58,-121,-119,-59,-58,-63,-63,-59,-58,-121,-119,-59,-58,-63,-63,-59,-58,-121,-119,-59,-58,-63,-63,-63,-63,-63,-70
-70,-127,-127,-127,-127,-127,-63,-43,-42,-105,-103,-43,-42,-63,-63,-43,-42,-89,-87,-43,-42,-63,-63,-43,-42,-89,-87,-43,-42,-63,-91,-90,-59,-58,-70
-70,-127,-127,-127,-127,-127,-63,-59,-58,-105,-103,-59,-58,-63,-63,-63,-63,-63,-63,-63,-63,-63,-63,-63,-63,-63,-63,-63,-63,-63,-75,-74,-43,-42,-70
-70,-127,-127,-127,-127,-127,-63,-43,-42,-105,-103,-43,-42,-63,-63,-63,-63,-63,-63,-63,-63,-63,-63,-63,-63,-63,-63,-63,-63,-63,-69,-68,-68,-68,-70
-70,-127,-127,-127,-127,-127,-63,-59,-58,-105,-103,-59,-58,-63,-63,-59,-58,-121,-119,-59,-58,-63,-63,-59,-58,-121,-119,-59,-58,-63,-63,-63,-63,-63,-70
-70,-127,-127,-127,-127,-127,-63,-43,-42,-105,-103,-43,-42,-63,-63,-43,-42,-89,-87,-43,-42,-63,-63,-43,-42,-89,-87,-43,-42,-63,-91,-90,-59,-58,-70
-70,-127,-127,-127,-127,-127,-63,-59,-58,-105,-103,-59,-58,-63,-63,-63,-63,-63,-63,-63,-63,-63,-63,-63,-63,-63,-63,-63,-63,-63,-75,-74,-43,-42,-70
-70,-127,-127,-127,-127,-127,-63,-43,-42,-105,-103,-43,-42,-63,-63,-63,-63,-63,-63,-63,-63,-63,-63,-63,-63,-63,-63,-63,-63,-63,-69,-68,-68,-68,-70
-70,-127,-127,-127,-127,-127,-63,-59,-58,-105,-103,-59,-58,-63,-63,-63,-63,-63,-59,-58,-59,-58,-59,-58,-59,-58,-63,-63,-63,-63,-63,-63,-63,-63,-70
-70,-127,-127,-127,-127,-127,-63,-43,-42,-89,-87,-43,-42,-63,-63,-63,-63,-63,-43,-42,-43,-42,-43,-42,-43,-42,-63,-63,-63,-63,-91,-90,-59,-58,-70
-70,-127,-127,-127,-127,-127,-63,-63,-63,-63,-63,-63,-63,-63,-63,-63,-63,-63,-121,-120,-120,-120,-120,-120,-120,-119,-63,-63,-63,-63,-75,-74,-43,-42,-70
-70,-127,-127,-127,-127,-127,-63,-63,-63,-63,-63,-63,-63,-63,-63,-63,-63,-63,-89,-88,-88,-88,-88,-88,-88,-87,-63,-63,-63,-63,-69,-68,-68,-68,-70
-70,-127,-127,-127,-127,-127,-63,-63,-63,-63,-63,-63,-63,-63,-63,-63,-63,-63,-59,-58,-59,-58,-59,-58,-59,-58,-63,-63,-63,-63,-63,-63,-63,-63,-70
-70,-127,-127,-127,-127,-127,-63,-63,-63,-63,-63,-63,-63,-63,-63,-63,-63,-63,-43,-42,-43,-42,-43,-42,-43,-42,-63,-63,-63,-63,-91,-90,-59,-58,-70
-70,-127,-127,-127,-127,-127,-63,-59,-58,-63,-63,-63,-63,-63,-63,-63,-63,-63,-63,-63,-63,-63,-63,-63,-63,-63,-63,-63,-63,-63,-75,-74,-43,-42,-70
-70,-127,-127,-127,-127,-127,-63,-43,-42,-63,-63,-63,-63,-63,-63,-63,-63,-63,-63,-63,-63,-63,-63,-63,-63,-63,-63,-63,-63,-63,-69,-68,-68,-68,-70
-70,-127,-127,-127,-127,-127,-63,-59,-58,-59,-58,-63,-63,-63,-63,-63,-59,-58,-59,-58,-59,-58,-59,-58,-59,-58,-59,-58,-63,-63,-63,-63,-63,-63,-70
-70,-127,-127,-127,-127,-127,-63,-43,-42,-43,-42,-63,-63,-63,-63,-63,-43,-42,-43,-42,-43,-42,-43,-42,-43,-42,-43,-42,-63,-63,-63,-63,-63,-63,-70
-70,-127,-127,-127,-127,-127,-127,-127,-127,-127,-127,-127,-127,-127,-127,-127,-127,-127,-127,-127,-127,-127,-127,-127,-127,-127,-127,-127,-127,-127,-127,-86,-54,-54,-70
-70,-127,-127,-127,-127,-127,-127,-127,-127,-127,-127,-127,-127,-127,-127,-127,-127,-127,-127,-127,-127,-127,-127,-127,-127,-127,-127,-127,-127,-127,-127,-70,-115,-114,-70
-70,-127,-127,-127,-127,-127,-127,-127,-127,-127,-127,-127,-127,-127,-127,-127,-127,-127,-127,-127,-127,-127,-127,-127,-127,-127,-127,-127,-127,-127,-127,-70,-99,-98,-70
-70,-127,-127,-127,-127,-127,-127,-127,-127,-126,-125,-127,-127,-127,-127,-127,-127,-127,-127,-127,-127,-126,-125,-127,-127,-127,-127,-127,-127,-127,-127,-124,-127,-127,-70
-70,-127,-127,-127,-127,-127,-127,-127,-127,-110,-109,-127,-127,-127,-127,-127,-127,-127,-127,-127,-127,-110,-109,-127,-127,-127,-127,-127,-127,-127,-127,-108,-127,-127,-70
-70,-127,-127,-127,-127,-127,-127,-127,-127,-127,-127,-127,-127,-127,-127,-127,-127,-127,-127,-127,-127,-127,-127,-127,-127,-127,-127,-127,-127,-127,-127,-70,-115,-114,-70
-70,-127,-127,-127,-127,-127,-127,-127,-127,-127,-127,-127,-127,-127,-127,-127,-127,-127,-127,-127,-127,-127,-127,-127,-127,-127,-127,-127,-127,-127,-127,-70,-99,-98,-70
-70,-127,-127,-127,-127,-127,-127,-127,-127,-127,-127,-127,-127,-121,-86,-95,-121,-120,-120,-119,-95,-95,-121,-120,-120,-119,-95,-86,-53,-127,-127,-70,-54,-54,-70
-70,-127,-127,-127,-127,-127,-127,-127,-127,-127,-127,-127,-127,-105,-70,-95,-105,-95,-95,-103,-95,-95,-105,-95,-95,-103,-95,-70,-127,-127,-127,-70,-104,-104,-104
-70,-127,-127,-127,-127,-127,-127,-127,-127,-127,-127,-127,-127,-105,-70,-95,-89,-95,-95,-95,-95,-95,-95,-95,-95,-103,-95,-70,-127,-127,-127,-70,-104,-104,-104
-70,-127,-127,-127,-127,-127,-127,-127,-127,-127,-127,-127,-127,-89,-70,-95,-95,-95,-95,-95,-95,-95,-95,-95,-95,-95,-95,-70,-121,-120,-119,-70,-104,-104,-104
-70,-127,-127,-127,-127,-127,-86,-54,-54,-54,-54,-54,-86,-54,-54,-54,-54,-54,-54,-54,-54,-54,-54,-78,-77,-54,-54,-54,-54,-54,-54,-70,-104,-104,-104
-70,-127,-127,-127,-127,-127,-70,-104,-104,-104,-104,-104,-70,-119,101,101,101,101,-121,-119,101,101,101,101,101,101,-70,101,101,-113,-112,-70,-104,-104,-104
-70,-127,-127,-127,-127,-127,-70,-104,-104,-104,-104,-104,-70,-103,101,101,-113,-112,-105,-103,101,101,101,101,101,101,-70,101,101,-97,-96,-70,-104,-104,-104
-70,-127,-127,-127,-127,-127,-70,-104,-104,-104,-104,-104,-70,-103,101,101,-97,-96,-89,-87,101,101,101,101,101,101,-70,101,101,-121,-119,-70,-104,-104,-104
-70,-127,-127,-127,-127,-127,-70,-104,-104,-104,-104,-104,-70,-103,101,101,101,101,101,101,101,101,101,101,101,101,101,101,101,-89,-87,-70,-104,-104,-104
-70,-127,-127,-127,-127,-127,-70,-104,-104,-104,-104,-104,-70,-103,101,101,101,101,101,101,101,101,101,101,101,101,101,101,101,101,101,-70,-104,-104,-104
-70,-127,-127,-127,-127,-127,-70,-104,-104,-104,-104,-104,-70,-103,101,101,-86,-53,101,101,-86,101,101,101,101,101,-70,101,101,101,101,-70,-104,-104,-104
-70,-127,-127,-127,-127,-127,-70,-104,-104,-104,-104,-104,-70,-87,101,101,-70,101,101,101,-70,101,101,101,101,101,-70,101,101,101,101,-70,-104,-104,-104
-70,-127,-127,-127,-127,-127,-70,-54,-54,-54,-54,-54,-70,-54,-54,-54,-54,-54,-54,-54,-54,-54,-54,-94,-92,-54,-54,-54,-54,-54,-54,-54,-54,-54,-53
-70,-127,-127,-127,-127,-127,-127,-127,-127,-127,-127,-127,-127,-127,-124,-79,-79,-79,-79,-79,-79,-79,-79,-79,-79,-79,-79,-79,-79,-70,-79,-79,-79,-79,-70
-70,-127,-127,-127,-127,-127,-127,-127,-127,-127,-127,-127,-127,-127,-108,-79,-79,-79,-79,-79,-79,-79,-79,-79,-79,-79,-79,-79,-79,-70,-79,-79,-79,-79,-70
-70,-127,-127,-127,-127,-127,-70,-54,-54,-54,-54,-54,-54,-54,-54,-79,-79,-79,-79,-79,-79,-79,-79,-79,-79,-79,-79,-79,-79,-70,-79,-79,-79,-79,-70
-70,-127,-127,-127,-127,-127,-70,-104,-104,-104,-104,-70,-79,-79,-79,-79,-79,-79,-79,-79,-79,-79,-79,-79,-79,-79,-79,-79,-79,-79,-79,-79,-79,-79,-70
-70,-127,-127,-127,-127,-127,-70,-104,-104,-104,-104,-70,-79,-79,-79,-79,-79,-79,-79,-79,-79,-79,-79,-79,-79,-79,-79,-79,-79,-79,-79,-79,-79,-79,-70
-70,-127,-127,-127,-127,-127,-70,-104,-104,-104,-104,-70,-79,-79,-79,-79,-121,-120,-120,-120,-120,-120,-120,-119,-79,-79,-79,-79,-79,-79,-79,-79,-79,-79,-70
-70,-127,-127,-127,-127,-127,-70,-104,-104,-104,-104,-70,-94,-92,-54,-86,-54,-54,-54,-54,-54,-54,-86,-54,-54,-54,-86,-79,-79,-79,-79,-79,-79,-79,-70
-70,-127,-127,-127,-127,-127,-70,-104,-104,-104,-104,-70,-79,-79,-79,-70,-104,-104,-104,-104,-104,-104,-70,-79,-79,-79,-70,-79,-79,-86,-79,-79,-79,-79,-70
-70,-127,-127,-127,-127,-127,-70,-104,-104,-104,-104,-70,-79,-79,-79,-70,-104,-104,-104,-104,-104,-104,-70,-79,-79,-79,-70,-79,-79,-70,-79,-79,-79,-79,-70
-70,-127,-127,-127,-127,-127,-70,-104,-104,-104,-104,-70,-79,-79,-79,-70,-104,-104,-104,-104,-104,-104,-70,-79,-79,-79,-124,-79,-79,-70,-79,-79,-79,-79,-70
-70,-127,-127,-127,-127,-127,-70,-104,-104,-104,-104,-70,-79,-79,-79,-70,-104,-104,-104,-104,-104,-104,-70,-79,-79,-79,-108,-79,-79,-70,-54,-54,-54,-54,-70
-70,-127,-127,-127,-127,-127,-70,-68,-68,-68,-68,-70,-54,-54,-54,-70,-54,-54,-54,-54,-54,-54,-70,-54,-54,-54,-53,-79,-79,-124,-79,-79,-79,-79,-70
-70,-127,-127,-127,-127,-127,-127,-127,-127,-127,-127,-124,-79,-79,-79,-79,-79,-79,-79,-79,-79,-79,-79,-79,-79,-79,-79,-79,-79,-108,-79,-79,-79,-79,-70
-70,-127,-127,-127,-127,-127,-127,-127,-127,-127,-127,-108,-79,-79,-79,-79,-79,-79,-79,-79,-79,-79,-79,-79,-79,-79,-79,-79,-79,-70,-54,-54,-54,-54,-70
-70,-127,-127,-127,-127,-127,-70,-68,-68,-68,-68,-70,-79,-79,-79,-79,-79,-79,-79,-79,-79,-79,-79,-79,-79,-79,-79,-79,-79,-79,-79,-79,-79,-79,-70
-70,-127,-127,-127,-127,-127,-70,-104,-104,-104,-104,-70,-54,-54,-79,-79,-79,-79,-79,-79,-79,-79,-79,-79,-79,-79,-79,-79,-79,-79,-79,-79,-79,-79,-70
-70,-127,-127,-127,-127,-127,-70,-104,-104,-104,-104,-70,-79,-79,-79,-79,-79,-79,-79,-79,-79,-79,-79,-79,-79,-79,-81,-80,-121,-120,-119,-81,-80,-79,-70
-70,-127,-127,-127,-127,-127,-70,-104,-104,-104,-104,-70,-79,-79,-79,-79,-79,-79,-79,-79,-79,-79,-79,-79,-79,-79,-65,-64,-105,-104,-103,-65,-64,-79,-70
-70,-127,-127,-127,-127,-127,-70,-104,-104,-104,-104,-70,-79,-79,-79,-79,-79,-79,-79,-79,-79,-79,-79,-79,-79,-79,-81,-80,-105,-104,-103,-81,-80,-79,-70
-70,-127,-127,-127,-127,-127,-70,-104,-104,-104,-104,-70,-79,-79,-79,-79,-79,-79,-79,-79,-79,-79,-79,-79,-79,-79,-65,-64,-89,-88,-87,-65,-64,-79,-70
-70,-127,-127,-127,-127,-127,-70,-104,-104,-104,-104,-70,-121,-120,-120,-120,-120,-120,-120,-119,-79,-79,-79,-79,-79,-79,-79,-79,-79,-79,-79,-79,-79,-79,-70
-70,-68,-68,-68,-68,-68,-70,-68,-68,-68,-68,-70,-54,-54,-54,-54,-54,-54,-54,-54,-54,-54,-54,-54,-54,-54,-54,-54,-54,-54,-54,-54,-54,-54,-70
